######..##
.......###
######....
##....1###
...#######